13313131313131313131313131313131313131141331313131313131313131313131313131313114133131313131313131313131313131313131311413313131313131313131313131313131313131141331313131313131313131313131313131313114
22000000000000000000000000000000000000303200000000000000000000000000000000000030320000000000000000000000000000000000003032000000000000000000000000000000000000303200000000000000000000000000000000000020
22000000000000000000000000000000000000000000000000000000000000000000000000000000000000000000000000000000000000000000000000000000000000000000000000000000000000000000000000000000000000000000000000000020
22000000000000000000000000000000000000000000000000000000000000000000000000000000000000000000000000000000000000000000000000000000000000000000000000000000000000000000000000000000000000000000000000000020
22000000000000000000000000000000000000000000000000000000000000000000000000000000000000000000000000000000000000000000000000000000000000000000000000000000000000000000000000000000000000000000000000000020
22000000000000000034333300000000000000000000000000000000000000000000000000000000000000000000000000000000000000000000000000000000000000000000000000000000000000000000000000000000000000000000000000000020
22000000000000000000000000000000000000000000000000000000000000000000000000000000000000000000000000000000000000000000000000000000000000000000000000000000000000000000000000000000000000000000000000000020
22000000000000000000000000000000000000000000000000000000000000000000000000000000000000000000000000000000000000000000000000000000000000000000000000000000000000000000000000000000000000000000000000000020
22000000000000000000000000333334000000000000000000000000000000000000000000000000000000000000000000000000000000000000000000000000000000000000000000000000000000000000000000000000000000000000000000000020
22000000000000000000000000000000000000000000000000000000000000000000000000000000000000000000000000000000000000000000000000000000000000000000000000000000000000000000000000000000000000000000000000000020
23120000000000000000000000000000000000101200000033343333000000003434340000000010120000003434000000000033343400000000001012000000333433000000003433000000000000101200000034333300000000333334340000001024
13320000000000000033333300000000000000303200000000000000000000000000000000000030320000000000000000000000000000000000003032000000000000000000000000000000000000303200000000000000000000000000000000003014
22000000000000000000000000000000000000000000000000000000000000000000000000000000000000000000000000000000000000000000000000000000000000000000000000000000000000000000000000000000000000000000000000000020
22000000000000000000000000000000000000000000000000000000000000000000000000000000000000000000000000000000000000000000000000000000000000000000000000000000000000000000000000000000000000000000000000000020
22000000003433340000000000000000000000000000000000000000000000000000000000000000000000000000000034333433000000000000000000000000000000000000000000000000000000000000000000000000000000000000000000000020
22000000000000000000000000000000000000000000000000000000000000000000000000000000000000000000000000000033000000000000000000000000000000000000000000000000000000000000000000000000000000000000000000000020
22000000000000000000000000000000000000000000000000000000000000000000000000000000000000000000000000343333000000000000000000000000000000000000000000000000000000000000000000000000000000000000000000000020
22000000000000000034343300000000000000000000000000000000000000000000000000000000000000000000000000000000000000000000000000000000000000000000000000000000000000000000000000000000000000000000000000000020
22000000000000000000000000000000000000000000000000000000000000000000000000000000000000000000000000343300000000000000000000000000000000000000000000000000000000000000000000000000000000000000000000000020
22000000000000000000000000000000000000000000000000000000000000000000000000000000000000000000000000000000000000000000000000000000000000000000000000000000000000000000000000000000000000000000000000000020
22000000000000000000000000333334000000000000000000000000000000000000000000000010120000000000000000000000000000000000001012000000000000000000000000000000000000000000000000000000000000000000000000000020
23120000000000000000000000000000000000101200000000000000000000000000000000001024231111111111111111111111111111111111112423120000000000000000000000000000000000101200000000000000000000000000000000001024
13320000000000000000000000000000000000303200000000000000000000000000000000003014133131313131313131313131313131313131311413320000000000000000000000000000000000303200000000000000000000000000000000003014
22000000000000000034343400000000000000000000000000000000000000000000000000000030320000000000000000000000000000000000003032000000000000000000000000000000000000000000000000000000000000000000000000000020
22000000000000000000000000000000000000000000000000000000000000000000000000000000000000000000000000000000000000000000000000000000000000000000000000000000000000000000000000000000000000000000000000000020
22000000000000000000000000000000000000000000000000000000000000000000000000000000000000000000000000000000000000000000000000000000000000000000000000000000000000000000000000000000000000000000000000000020
22000000003334340000000000000000000000000000000000000000000000000000000000000000000000000000000000000000000000000000000000000000000000000000000000000000000000000000000000000000000000000000000000000020
22000000000000000000000000000000000000000000000000000000000000000000000000000000000000000000000000000000000000000000000000000000000000000000000000000000000000000000000000000000000000000000000000000020
22000000000000000000000000000000000000000000000000000000000000000000000000000000000000000000000000000000000000000000000000000000000000000000000000000000000000000000000000000000000000000000000000000020
22000000000000000034343400000000000000000000000000000000000000000000000000000000000000000000000000000000000000000000000000000000000000000000000000000000000000000000000000000000000000000000000000000020
22000000000000000000000000000000000000000000000000000000000000000000000000000000000000000000000000000000000000000000000000000000000000000000000000000000000000000000000000000000000000000000000000000020
22000000000000000000000000000000000000000000000000000000000000000000000000000010120000000000010202020202020300000000001012000000000000000000000000000000000000000000000000000000000000000000000000000020
23120000000000000000000000333334000000101200000000000000000000000000000000001024231111111111111111111111111111111111112423120000000000000000000000000000000000101200000000000000000000000000000000001024
13320000000000000000000000000000000000303200003433000000000000333334000000003014133131313131313131313131313131313131311413320000000000000000000000000000000000303200000000000000000000000000000000003014
22000000000000000000000000000000000000000000000000000000000000000000000000000030320000000000000000000000000000000000003032000000000000000000000000000000000000000000000000000000000000000000000000000020
22000000000000000000000000000000000000000000000000000000000000000000000000000000000000000000000000000000000000000000000000000000000000000000000000000000000000000000000000000000000000000000000000000020
22000000000000000000000000000000000000000000000000003434340000000000000000000000000000000000000000000000000000000000000000000000000000000000000000000000000000000000000000000000000000000000000000000020
22000000000000000000000000000000000000000000000000000000000000000000000000000000000000000000000000000000000000000000000000000000000000000000000000000000000000000000000000000000000000000000000000000020
22000000000000000000000000000000000000000000000000000000000000000000000000000000000000000000000000000000000000000000000000000000000000000000000000000000000000000000000000000000000000000000000000000020
22000000000000000000000000000000000000000000000000000000000000333334000000000000000000000000000000000000000000000000000000000000000000000000000000000000000000000000000000000000000000000000000000000020
22000000000000000000000000000000000000000000000000000000000000000000000000000000000000000000000000000000000000000000000000000000000000000000000000000000000000000000000000000000000000000000000000000020
22000000000000000000000000000000000000000000000000000000000000000000000000000000000000000000000000000000000000000000000000000000000000000000000000000000000000000000000000000000000000000000000000000020
22000000000000000000000000000000000000000000000000003434330000000000000000000000000000000000000000000000000000000000000000000000000000000000000000000000000000000000000000000000000000000000000000000020
23120000000000000000000000000000000000101200000000000000000000000000000000000010120000000000000000000000000000000000001012000000000000000000000000000000000000101200000000000000000000000000000000001024
13320000000000000000000000000000000000303200000000000000000000000000000000000030320000000000000000000000000000000000003032000000000000000000000000000000000000303200000000000000000000000000000000003014
22000000000000000000000000000000000000000000000000000000000000333434000000000000000000000000000000000000000000000000000000000000000000000000000000000000000000000000000000000000000000000000000000000020
22000000000000000000000000000000000000000000000000000000000000000000000000000000000000000000000000000000000000000000000000000000003334333300000000000000000000000000000000003400343300000000000000000020
22000000000000330000000000000000000000000000000000000000000000000000000000000000000000000033331012000000000000000000000000000000000000003400000000000000000000000000000000003300003400000000000000000020
22000000000000340000000000000000000000000000000000003334330000000000000000000000000000000000003032000000000000000000000000000000000000003300000000000000000000000000000000001012333400000000000000000020
22000000000000330000000000000000000000000000000000000000000000000000000000000000000000000000003400000000000000000000000000000000000000343333000000000000000000000000000000003032003400000000000000000020
22000000000000340000000000000000000000000000000000000000000000343333000000000000000000000000003334330000000000000000000000000000000000000033000000000000000000000000000000000000003300000000000000000020
22000000000000000000000000000000000000000000000000000000000000000000000000000000000000000000000000000000000000000000000000000000000034333333000000000000000000000000000000000000003300000000000000000020
22000000000000000000000000000000000000000000000000000000000000000000000000000000000000000000000000000000000000000000000000000000000000000000000000000000000000000000000000000000000000000000000000000020
22000000000000000000000000000000000000101200000000000000000000000000000000000010120000000000000000000000000000000000001012000000000000000000000000000000000000101200000000000000000000000000000000000020
23111111111111111111111111111111111111242311111111111111111111111111111111111124231111111111111111111111111111111111112423111111111111111111111111111111111111242311111111111111111111111111111111111124

image image:terrain
sprite @44,31 sprite:hero (u32)0
sprite @55,31 sprite:moon (u32)0
camlock @40,22,20,11 (u8:camlock)offeratorium 0x000000
sprite @32,32 sprite:marshmallow (u32)0
sprite @11,53 sprite:fish (u32)0
sprite @28,53 sprite:tomato (u32)0
sprite @63,53 sprite:trampoline (u32)0
sprite @51,53 sprite:magnet (u32)0
sprite @66,50 sprite:balloon (u32)0
sprite @10,4 sprite:teacup (u32)0
sprite @44,20 sprite:fan (u32)0
