21211331313131313131313131313131311421211331313131313131313131313131313131313131313131313131313131313131313131313131311421212121212121212121133131313131313131313131313131313131313131313131313131313114
21133251515151515151515151515151513014212251515151515151515151515151515151515151515151515151515151515151515151515151512021212121212121212121225151515151515151515151515151515151515151515151515151515120
13325151515151515151515151515151515130142251515151515151515151515151515151515151515151515151515151515151515151515151512021133131313131311421225151515151515151515151515151515151515151515151515151515120
22515151515151515151515151515151515151202251515151515151515151515151515151515151515151515143616161444361616144515151513031325151515151513031325151515151515151515151515151515151515151515151515151515120
22515151515151515151515151515151515151202251515151515151515151515151515151515151515143616162000000606200000060616144515151515151515151515151515151515151515151515151515151515151515151515151515151515120
22614451515151515108090a51515151515151202251515151515151515151436161616161611011126162000000000000000000000000000060616161616161614451515151515151515151515151515151515151515151515151515151515151515120
22006061614451515151515151515151515151202251515151515143616161620000000000003031320000000000404200000000000000000000000000000000006061614451515151515151515151515151515151515151515151515151515151515120
22000000005051515151515151515151515151202251515151436162000000000000000000000000000000000000505342000000000000000000000000000000000000005051515151515151515151515151515151515151515151515151515151515120
22000000005051515151515151515151515151202251515143620000000000000000000000000000000000000000606162000000000000000000001012000000000000005010125151515108090909090909090909090909090a51515151515151515120
22000000005043616161445151515151515151202251436162000000000000000000000000000000000000000000000000000000000000000000002022000000000000405420225151515151515151515151515151515151515151515151515151515120
22000000006062000000604451515151515151202243620000000000101111111111120000000000000000001011111111111111111111111111112423111200000010111124225151515151515151515151515151515151515151515151515151515120
2200006400000000000000606161445151514320226200000000000030313131313132000000000000004041303131313131313131313131313131141331320000003031311422515151515151515151515151515151515151515151510809090a515120
22000000000000000000000000005043616162202200001516170000000000000000000000000000004054515151520000000000000000000000002022000015161700005020225151515151515151515151515151515151515151515151515151515120
22000000000000000000000000006062000000303200000000000000000000000000000000000000405451515151520000000000000000000000002022000000000000005020225151515151515151515151515151515151515151515151515151515120
2200000000151617000000000000000000000000000000000000000000000000000000000000000060614451514362000000000000000000000000303200000000000000602022515151515151515151080909090909090909090a515151515151515120
22000000000000000000000000000000000000000000000000000000000000000000000000000000000060616162000000000000000000000000000000000000000000000020225151515151515151515151515143616161445151515151515151515120
22000000000000000000000000000000000000000000001516170000000000000000000000000000000000000000000000000000000000000000000000000015161700000020226161614451515151514361616162000000606161616144515151515120
2200000000000000001516170000000000000000000000000000000000000000000000000000000000000000000000000000000000000000000000000000000000000000002022000000604451080a436200000000000000000000000060445151515120
22000000000000000000000000000000000000000000000000000000001012000000000000000000000000000000000000000000000000000000000000000000000000000020220000000050515151520000000000000000000000000000606161616120
22000000000000000000000000000000000000000000000000000000002022000000000000000000000000000000000015161617000000000000000000000000000000000020220000000060616161620000000000000000000000000000000000000020
22000000000000000000000000151616161617000000000000000000002022000000000000000000000000000000000000000000000000000000001012000015161700000020220000000000000000000015161616161616161700000000000000000020
22000000000000000000000000000000000000000000101111111111112423111111111111111111111111111111120000000000001011111111112423111200000010111124220000000000000000000000000000000000000000000000000000000020
22000000000000000000000000000000000000000000201331313131313131313131313131313114133131313131320000151616173031313131311413313200000030313114220000000000000000000000000000000000000000000000000000000020
22000000000000000015161700000000000000000000202200000000000000000000000000000020220000000000000000000000000000000000002022000000000000000020220000000000000000000000000000000000000000000015161700000020
22000000000000000000000000000000000000000000202200000000000000000000000000000030320000000000000000000000000000000000003032000015161700000020220000000000000000000000000000000000000000000000000000000020
22000000000000000000000000000000000000000000202200000000000000000000000000000000000000000000000000000000000000000000000000000000000000000020220000000000000000000000000000000000000000000000000000000020
22000000001516170000000000000000004546470000303200000000000000000000454647000000000000000000000000000000000000000000000000000000000045464720220000000000000000000000001516161616161616170000000000000020
22000000000000000000000000000000005556570000000000000000001011120000555657000000000000000000000000000000000000000000000000000000000055565720220000000000000000000000000000000000000000000000000000000020
22000000000000000000000000000000006566670000000000000000003031320000656667000000000000000000000000000000000000000000000000000015161765666720220000000000000000000000000000000000000000000000000000000020
22000000000000000015161700000000000000000000000000000000000000000000000000000000000000000000000000000000000000000000000000000000000000000020220000000000000000151700000000000000000000000000000000000020
22000000000000000000000000000000000000000000000000000000000000000000000000000010120000000000000000000000000000000000001012000000000000000020220000000000000000000000000000000000000000000000000000000020
22000000000000000000000000000000000000000000000000000000000000000000000000000020220000000000010202020202020300000000002022000000000000000020220000000000000000000000000000000000000000000000000000000020
22000000000000000000000000001516170000101111111111111111111111111111111111111124231111111111111111111111111111111111112423111215161710111124220000000000000000000000151616161616161617000000000000000020
22000000000000000000151700000000000000202121212121212121212121212121212121212121133131313131313131313131313131313131313131313200000030313114220000000000000000000000000000000000000000000000000000000020
22000000000000000000000000000000000000202121212121212121212121212121212121211331320000000000000000000000000000000000000000000000000000000020220000000000000000000000000000000000000000000000000000000020
22000000000000000000000000000000000000202121212121212121212121212121212113313200000000000000000000000000000000000000000000000000000000000020220000000000000000000000000000000000000000000015161700000020
22000015161616161700000000000000000000303131313131313131313131313131313132000000000000000000000000000000000000000000000000001516161700000020220000000000000000000000000000000000000000000000000000000020
22000000000000000000000000000000000000000000000000000000000000000000000000000000000045464700000000000000000000000000000000000000000000000020220000000000000000000000000000000000000000000000000000000020
22000000000000000000000000000000000000000000000000000000000000000000000000000000000055565700000000000000000000000000000000000000000000000020220000000000000000000015161616161616161616170000000000000020
22000000000000000000000000000000000000000000000000000000000000000000000000000000000065666700000000000000000000000000000000000000000000000020220000000000000000000000000000000000000000000000000000000020
23111200000000151616161616161617000000000000000000000000000000000000000000000000000000000000000000000000000000000000000000101111111111111124220000000000000000000000000000000000000000000000000000000020
21212200000000000000000000000000000000000000000000000000000000000000000000000000000000000000000000000000000000000010111111242121212121212121220000000000001516170000000000000000000000000000000000000020
21212311120000000000000000000000000000000000000000000000000000000000000000000000000000000000000000000000000000000020212121212121212121212121220000000000000000000000000000000000000000000000000000000020
21212121220000000000000000000000000000000000000000000000000000000000000000001011111111111111111111111112000000000020212121212121212121212121220000000000000000000000000000000000000000000000000000000020
21212121231111111111111111111111111111111111111200000000000000001819000000003014212121212121212121212122000000000030313131313131313131313114220000000000000000000000151616161616161616170000000000000020
21212121212121212121212121212121212121212121212200000000000000000000000000000030311421212121212121212122000000000000000000000018190000000020220000000000000000000000000000000000000000000000000000000020
21212121212121212121212121212121212121212121212311120000000000151616170000000018193031142121212121212122000000000000000000000000000000000020220000000000004546470000000000000000000000000000000000000020
21212121212121212121212121212121212121212121212121220000000000000000000000000000000000303131142121212122000000000000000000000000000000000020220000000000005556570000000000000000000000000015161617000020
21212121212121212121212121212121212121212121212121231112000000000000000000000000000000000000303131142123111111111111111111111112000000000020220000000000006566670000000000000000000000000000000000000020
21212121212121212121212121212121212121212121212121212122000000000000000000000000000000000000000000303131142121212113313131313132000000000020220000000000000000000000000000000000000000000045464700000020
21212121212121212121212121212121212121212121212121212123111200000000151616161700000000000000000000001819303131313132000018190000001516170020231111120000000000001516161616161616161700000055565700000020
21212121212121212121212121212121212121212121212121212121212200000000000000000000000000000000000000000000000000000000000000000000000000000020133131320000000000000000000000000000000000000065666700000020
21212121212121212121212121212121212121212121212121212121212311120000000000000000000000000000000000000000000000000000000000000000000000000020220000000000000000000000000000000000000000000000000000000020
21212121212121212121212121212121212121212121212121212121212121220000000000000000000000000000000000000000000000000000000000000000000000000020220000000000000000000000000000000000000000000000000000000020
21212121212121212121212121212121212121212121212121212121212121231111111111111111111111111111111111111111111111111111111111111111111111111124231111111111111111111111111111111111111111111111111111111124

image image:terrain
sprite @44,31 sprite:hero (u32)0
sprite @55,31 sprite:moon (u32)0
camlock @40,22,20,11 (u8:camlock)offeratorium 0x000000
sprite @30,26 sprite:marshmallow (u32)0
sprite @39,4 sprite:fish (u32)0
sprite @48,42 sprite:tomato (u32)0
sprite @46,42 sprite:trampoline (u32)0
sprite @34,53 sprite:magnet (u32)0
sprite @72,52 sprite:balloon (u32)0
sprite @10,4 sprite:teacup (u32)0
sprite @34,20 sprite:fan (u32)0
