21211331313131313131313131313131311421211331313131313131313131313131313131313131313131313131313131313131313131313131311421212121212121212121133131313131313131313131313131313131313131313131313131313114
21133200000000000000000000000000003014212200000000000000000000000000000000000000000000000000000000000000000000000000002021212121212121212121220000000000000000000000000000000000000000000000000000000020
13320000000000000000000000000000000030142200000000000000000000000000000000000000000000000000000000000000000000000000002021133131313131311421220000000000000000000000000000000000000000000000000000000020
22000000000000000000000000000000000000202200000000000000000000000000000000000000000000000000000000000000000000000000003031320000000000003031320000000000000000000000000000000000000000000000000000000020
22000000000000000000000000000000000000202200000000000000000000000000000000000000000000000000000000000000000000000000000000000000000000000000000000000000000000000000000000000000000000000000000000000020
22000000000000000015161700000000000000202200000000000000000000000000000000001011120000000000000000000000000000000000000000000000000000000000000000000000000000000000000000000000000000000000000000000020
22000000000000000000000000000000000000202200000000000000000000000000000000003031320000000000000000000000000000000000000000000000000000000000000000000000000000000000000000000000000000000000000000000020
22000000000000000000000000000000000000202200000000000000000000000000000000000000000000000000000000000000000000000000000000000000000000000000000000000000000000000000000000000000000000000000000000000020
22000000000000000000000000000000000000202200000000000000000000000000000000000000000000000000000000000000000000000000001012000000000000000010120000000015161616161616161616161616161700000000000000000020
22000000000000000000000000000000000000202200000000000000000000000000000000000000000000000000000000000000000000000000002022000000000000000020220000000000000000000000000000000000000000000000000000000020
22000000000000000000000000000000000000202200000000000000101111111111120000000000000000001011111111111111111111111111112423111200000010111124220000000000000000000000000000000000000000000000000000000020
22000000000000000000000000000000000000202200000000000000303131313131320000000000000000003031313131313131313131313131311413313200000030313114220000000000000000000000000000000000000000000015161617000020
22000000000000000000000000000000000000202200001516170000000000000000000000000000000000000000000000000000000000000000002022000015161700000020220000000000000000000000000000000000000000000000000000000020
22000000000000000000000000000000000000303200000000000000000000000000000000000000000000000000000000000000000000000000002022000000000000000020220000000000000000000000000000000000000000000000000000000020
22000000001516170000000000000000000000000000000000000000000000000000000000000000000000000000000000000000000000000000003032000000000000000020220000000000000000001516161616161616161617000000000000000020
22000000000000000000000000000000000000000000000000000000000000000000000000000000000000000000000000000000000000000000000000000000000000000020220000000000000000000000000000000000000000000000000000000020
22000000000000000000000000000000000000000000001516170000000000000000000000000000000000000000000000000000000000000000000000000015161700000020220000000000000000000000000000000000000000000000000000000020
22000000000000000015161700000000000000000000000000000000000000000000000000000000000000000000000000000000000000000000000000000000000000000020220000000000001517000000000000000000000000000000000000000020
22000000000000000000000000000000000000000000000000000000001012000000000000000000000000000000000000000000000000000000000000000000000000000020220000000000000000000000000000000000000000000000000000000020
22000000000000000000000000000000000000000000000000000000002022000000000000000000000000000000000015161617000000000000000000000000000000000020220000000000000000000000000000000000000000000000000000000020
22000000000000000000000000151616161617000000000000000000002022000000000000000000000000000000000000000000000000000000001012000015161700000020220000000000000000000015161616161616161700000000000000000020
22000000000000000000000000000000000000000000101111111111112423111111111111111111111111111111120000000000001011111111112423111200000010111124220000000000000000000000000000000000000000000000000000000020
22000000000000000000000000000000000000000000201331313131313131313131313131313114133131313131320000151616173031313131311413313200000030313114220000000000000000000000000000000000000000000000000000000020
22000000000000000015161700000000000000000000202200000000000000000000000000000020220000000000000000000000000000000000002022000000000000000020220000000000000000000000000000000000000000000015161700000020
22000000000000000000000000000000000000000000202200000000000000000000000000000030320000000000000000000000000000000000003032000015161700000020220000000000000000000000000000000000000000000000000000000020
22000000000000000000000000000000000000000000202200000000000000000000000000000000000000000000000000000000000000000000000000000000000000000020220000000000000000000000000000000000000000000000000000000020
22000000001516170000000000000000000000000000303200000000000000000000000000000000000000000000000000000000000000000000000000000000000000000020220000000000000000000000001516161616161616170000000000000020
22000000000000000000000000000000000000000000000000000000001011120000000000000000000000000000000000000000000000000000000000000000000000000020220000000000000000000000000000000000000000000000000000000020
22000000000000000000000000000000000000000000000000000000003031320000000000000000000000000000000000000000000000000000000000000015161700000020220000000000000000000000000000000000000000000000000000000020
22000000000000000015161700000000000000000000000000000000000000000000000000000000000000000000000000000000000000000000000000000000000000000020220000000000000000151700000000000000000000000000000000000020
22000000000000000000000000000000000000000000000000000000000000000000000000000010120000000000000000000000000000000000001012000000000000000020220000000000000000000000000000000000000000000000000000000020
22000000000000000000000000000000000000000000000000000000000000000000000000000020220000000000010202020202020300000000002022000000000000000020220000000000000000000000000000000000000000000000000000000020
22000000000000000000000000001516170000101111111111111111111111111111111111111124231111111111111111111111111111111111112423111215161710111124220000000000000000000000151616161616161617000000000000000020
22000000000000000000151700000000000000202121212121212121212121212121212121212121133131313131313131313131313131313131313131313200000030313114220000000000000000000000000000000000000000000000000000000020
22000000000000000000000000000000000000202121212121212121212121212121212121211331320000000000000000000000000000000000000000000000000000000020220000000000000000000000000000000000000000000000000000000020
22000000000000000000000000000000000000202121212121212121212121212121212113313200000000000000000000000000000000000000000000000000000000000020220000000000000000000000000000000000000000000015161700000020
22000015161616161700000000000000000000303131313131313131313131313131313132000000000000000000000000000000000000000000000000001516161700000020220000000000000000000000000000000000000000000000000000000020
22000000000000000000000000000000000000000000000000000000000000000000000000000000000000000000000000000000000000000000000000000000000000000020220000000000000000000000000000000000000000000000000000000020
22000000000000000000000000000000000000000000000000000000000000000000000000000000000000000000000000000000000000000000000000000000000000000020220000000000000000000015161616161616161616170000000000000020
22000000000000000000000000000000000000000000000000000000000000000000000000000000000000000000000000000000000000000000000000000000000000000020220000000000000000000000000000000000000000000000000000000020
23111200000000151616161616161617000000000000000000000000000000000000000000000000000000000000000000000000000000000000000000101111111111111124220000000000000000000000000000000000000000000000000000000020
21212200000000000000000000000000000000000000000000000000000000000000000000000000000000000000000000000000000000000010111111242121212121212121220000000000001516170000000000000000000000000000000000000020
21212311120000000000000000000000000000000000000000000000000000000000000000000000000000000000000000000000000000000020212121212121212121212121220000000000000000000000000000000000000000000000000000000020
21212121220000000000000000000000000000000000000000000000000000000000000000001011111111111111111111111112000000000020212121212121212121212121220000000000000000000000000000000000000000000000000000000020
21212121231111111111111111111111111111111111111200000000000000000000000000003014212121212121212121212122000000000030313131313131313131313114220000000000000000000000151616161616161616170000000000000020
21212121212121212121212121212121212121212121212200000000000000000000000000000030311421212121212121212122000000000000000000000000000000000020220000000000000000000000000000000000000000000000000000000020
21212121212121212121212121212121212121212121212311120000000000151616170000000000003031142121212121212122000000000000000000000000000000000020220000000000000000000000000000000000000000000000000000000020
21212121212121212121212121212121212121212121212121220000000000000000000000000000000000303131142121212122000000000000000000000000000000000020220000000000000000000000000000000000000000000015161617000020
21212121212121212121212121212121212121212121212121231112000000000000000000000000000000000000303131142123111111111111111111111112000000000020220000000000000000000000000000000000000000000000000000000020
21212121212121212121212121212121212121212121212121212122000000000000000000000000000000000000000000303131142121212113313131313132000000000020220000000000000000000000000000000000000000000000000000000020
21212121212121212121212121212121212121212121212121212123111200000000151616161700000000000000000000000000303131313132000000000000001516170020231111120000000000001516161616161616161700000000000000000020
21212121212121212121212121212121212121212121212121212121212200000000000000000000000000000000000000000000000000000000000000000000000000000020133131320000000000000000000000000000000000000000000000000020
21212121212121212121212121212121212121212121212121212121212311120000000000000000000000000000000000000000000000000000000000000000000000000020220000000000000000000000000000000000000000000000000000000020
21212121212121212121212121212121212121212121212121212121212121220000000000000000000000000000000000000000000000000000000000000000000000000020220000000000000000000000000000000000000000000000000000000020
21212121212121212121212121212121212121212121212121212121212121231111111111111111111111111111111111111111111111111111111111111111111111111124231111111111111111111111111111111111111111111111111111111124

image image:terrain
sprite @44,31 sprite:hero (u32)0
sprite @55,31 sprite:moon (u32)0
camlock @40,22,20,11 (u8:camlock)offeratorium 0x000000
sprite @30,26 sprite:marshmallow (u32)0
sprite @39,4 sprite:fish (u32)0
sprite @48,42 sprite:tomato (u32)0
sprite @46,42 sprite:trampoline (u32)0
sprite @34,53 sprite:magnet (u32)0
sprite @72,52 sprite:balloon (u32)0
sprite @10,4 sprite:teacup (u32)0
sprite @34,20 sprite:fan (u32)0
